12
8
#############
#...........#
#...........#
#.....S.....#
#...........#
#...........#
#############
