12
9
############
##...*..*.*#
#**.*..*.*.#
#S..#.*..**#
#..**.*#..*#
#**.*#P.**.#
#..*..**.*.#
#*.*...*.*.#
############
