16
11
################
#..##.#.#.#.##.#
#.#..###P###..##
##.##.*.*...##.#
###....***.*...#
##*.*.*.*...*.*#
##*..*.*****..*#
##***.*.S*..***#
################
###...####...###
################