12
7
############
#..*....#.*#
##..***#P**#
#..*....#.*#
#**.*#...*.#
#S.*...*.*.#
############
