16
11
################
#...........*..#
#*.**########..#
#*.**######...##
#*..******#.####
#S*....*.P#....#
#.***********..#
#.**.......***.#
#.***********.*#
#..*...........#
################
