7 7
#######
#....P#
#.....#
#.....#
#.....#
#S....#
#######
